000000000000000
032111111111230
020101010101020
011111111111110
010101010101010
011111111111110 
010101101101010
011111111111110
010101010101010
011111111111110
020101010101020
032111111111230
000000000000000
